10
5
######_###
#$      ##
#     !! #
o     $$ #
##########
