11
6
###########
#T    $   #
# # ! $#!##
o # ! $!! _
#     !   #
###########
