19
24
##o################
_   #       #$    #
#   #       # $ $ #
#   #       #$  $ #
#  !#    !  #   $ #
#   #       #   ! #
#   #       #     #
#           #     #
#           #     #
#           #     #
#          $#     #
#           #     #
#    $      #     #
#           #     #
#$   T      #     #
#           #     #
#           # #####
#           #  $$ #
#   $$$$ ######## #
#        #        #
#        #  #     #
#        $  # #####
#$  $    !  #  $$$#
###################
