19 10
###################
o   #        $    #
#   #        $    #
#   #   ! # $     #
#   T   # #     $ #
#   ####  # #  #  _
#  # $    #    #  #
#   #$    !     # #
#   #$    #$$$$ # #
###################