19 10
###################
o   #        $    #
#   #        $    #
#   #   ! # $     #
#       # #     $ #
#         # #     _
#         #       #
#               # #
#          $$$$ # #
###################